11111111
10001101
10000001
10000001
10001001
10020001
10000001
10000001
11111111
