NO xpm/dont.xpm
SO xpm/dont.xpm
WE xpm/dont.xpm
EA xpm/dont.xpm
D xpm/dont.xpm
F 184,113,39
C 51,198,227
11111111111111111111111111111111111
11000000000001000000000100000001011
10111111111100011111110001111111011
10011111111111111111111111111111011
11011111111110001111110001111111211
10011111111110S02000000100000000011
10111111111110001111100001111111211
10111111110001111111111110101111011
10000000000100000000000000100000111
11111111111111111111111111111111111
